15 15
000000000000000
011111111111110
011111111111110
011111111111110
011112222111110
011112222111110
011112222111110
011112222111110
011111111111110
011111111111110
011111111111110
011111111111110
011111111111110
011111111111110
000000000000000