15 15
000000000000000
011111111111110
011111111113110
011111131111110
011112222111110
011112222111110
011112222111110
011112222111110
011111111111110
011111113111110
011111111111110
011131111111110
011111111111110
011111111111110
000000000000000