15 15
111111111111111
011111111111110
011111111113110
011111131100110
011112222100110
011112222100110
011112222111110
011112222111110
011111111111110
011111113111110
011111111111110
011131111111110
011111111111110
041111111111110
000000000000000